########################################################################################################################################################################################################
########################################################################################################################################################################################################
########################################################################################################################################################################################################
########################################################################################################################################################################################################
########################################################################################################################################################################################################
########################################################################################################################################################################################################
########################################################################################################################################################################################################
########################################################################################################################################################################################################
########################################################################################################################################################################################################
########################################################################################################################################################################################################
########################################################################################################################################################################################################
########################################################################################################################################################################################################
########################################################################################################################################################################################################
########################################################################################################################################################################################################
########################################################################################################################################################################################################
########################################################################################################################################################################################################
########################################################################################################################################################################################################
########################################################################################################################################################################################################
######################################........##########################################################################################################################################################
#####################################...........########################################################################################################################################################
#####################################...........########################################################################################################################################################
#####################################.......................############################################################################################################################################
#####################################.........................##########################################################################################################################################
#####################################.................#####...##########################################################################################################################################
######################################................##@##...##########################################################################################################################################
#########################################.....................##########################################################################################################################################
###################################################...........##########################################################################################################################################
###################################################...........##########################################################################################################################################
###################################################...........##########################################################################################################################################
####################################################...........#########################################################################################################################################
####################################################...........#########################################################################################################################################
####################################################...........#########################################################################################################################################
####################################################...........#####################################################...#################################################################################
####################################################...........###################################################........##############################################################################
####################################################...........##################################################..........#############################################################################
####################################################...........##################################################...........############################################################################
####################################################...........##################################################....#####..############################################################################
###########################....................................##################################################....##@##..############################################################################
#########################......................................##################################################...........############################################################################
#########################......................................##################################################...........############################################################################
##########################.....................................##################################################...........############################################################################
###########################............#############...........##################################################...........############################################################################
###########################...........##############.......................######################################...........############################################################################
###########################...........##############.........................###################################....................................................####################################
###########################.....###...##############.........................................................................................####.....................##################################
###########################....#@@##..###############........................................................................................##@##.....................#################################
###########################...........#################................................................................................................................#################################
###########################...........#############################....................................................................................................#################################
############################.........##############################...........################################...........###################################...........#################################
################################.##################################...........################################...........#########################.....................#################################
###################################################################.....####..################################...........#########...........###.......................#################################
###################################################################....##@@#..################################...........########...........##@@#......................#################################
###################################################################...........################################...........########......................................#################################
###################################################################..........#################################...........#########...................................###################################
#####################################################################......###################################...........###############################################################################
##############################################################################################################...........###############################################################################
##############################################################################################################...........###############################################################################
##############################################################################################################...........###############################################################################
##############################################################################################################...........###############################################################################
##############################################################################################################........................................##################################################
#####################################################################...................................................................................################################################
###################################################################..............................................................................####...################################################
##################################################################.......####...................................................................##@@#...################################################
###################################################################......#@@##........................................................................##################################################
####################################################################.............................................#######################################################################################
######################################################################################################...........#######################################################################################
######################################################################################################...........#######################################################################################
######################################################################################################...........#######################################################################################
######################################################################################################...........#######################################################################################
######################################################################################################...........#######################################################################################
######################################################################################################...........#######################################################################################
######################################################################################################.....###...#######################################################################################
######################################################################################################....#@@@#..#######################################################################################
######################################################################################################...........#######################################################################################
######################################################################################################...........#######################################################################################
#######################################################################################################........#########################################################################################
########################################################################################################################################################################################################
########################################################################################################################################################################################################
########################################################################################################################################################################################################
########################################################################################################################################################################################################
########################################################################################################################################################################################################
########################################################################################################################################################################################################
########################################################################################################################################################################################################
########################################################################################################################################################################################################
########################################################################################################################################################################################################
########################################################################################################################################################################################################
########################################################################################################################################################################################################
########################################################################################################################################################################################################
########################################################################################################################################################################################################
########################################################################################################################################################################################################
########################################################################################################################################################################################################
########################################################################################################################################################################################################
########################################################################################################################################################################################################
########################################################################################################################################################################################################
########################################################################################################################################################################################################
########################################################################################################################################################################################################
########################################################################################################################################################################################################
########################################################################################################################################################################################################
########################################################################################################################################################################################################
########################################################################################################################################################################################################
