########################################################################################################################################################################################################
########################################################################################################################################################################################################
########################################################################################################################################################################################################
########################################################################################################################################################################################################
########################################################################################################################################################################################################
########################################################################################################################################################################################################
########################################################################################################################################################################################################
########################################################################################################################################################################################################
########################################################################################################################################################################################################
########################################################################################################################################################################################################
########################################################################################################################################################################################################
########################################################################################################################################################################################################
########################################################################################################################################################################################################
########################################################################################################################################################################################################
################################################################################################################     ###################################################################################
###############################################################################################################                             ############################################################
###############################################################################################################                             B############################################################
###############################################################################################################    #####################################################################################
###############################################################################################################    #####################################################################################
###############################################################################################################    #####################################################################################
###############################################################################################################    #####################################################################################
###############################################################################################################    #####################################################################################
###############################################################################################################    #####################################################################################
###############################################################################################################    #####################################################################################
###############################################################################################################    #####################################################################################
###############################################################################################################    #####################################################################################
####################################A   ###########################################################                ####################################    ##############################################
####################################    ##########################################################                 ####################################    #############################################
####################################    ##########################################################                #####################################    #############################################
####################################    ##########################################################    #################################################    #############################################
####################################    ##########################################################    #################################################    #############################################
####################################    ##########################################################    #################################################    #############################################
####################################    ##########################################################    #################################################    #############################################
####################################    ##########################################################    ################################# ###############    #############################################
####################################    ##########################################################    ###############################    ##############    #############################################
####################################    ##########################################################    ###############################    ##############    #############################################
####################################    ##########################################################    ###############################    ##############    #############################################
####################################    ##########################################################    ###############################    ##############    #############################################
####################################    ##########################################################    ###############################    ##############    #############################################
####################################    ##########################################################    ###############################    ##############    #############################################
####################################              ################################################    ###############################    ##############    #############################################
####################################               ###############################################                                                                         #############################
####################################               ##############################################                                                                           ############################
####################################   #########    ##############################################                                                             #########    ############################
####################################   #########    ##############################################    ##############################    ################################    ############################
####################################   #########    ##############################################    ##############################    ################################    ############################
###################################    #########    ##############################################    ##############################    ################################    ############################
###################################    #########    ##############################################    ###############################  #################################    ############################
###################################    #########    ##############################################    ##################################################################    ############################
###################################    #########    ##############################################    ##################################################################   ############################
###################################    #########    ##############################################    ##################################################################################################
###################################    #########    ##############################################    ##################################################################################################
###################################    #########    ##############################################    ##################################################################################################
###########################            #########    ##############################################    ##################################################################################################
###########################            #########    ##############################################    ##################################################################################################
###########################            #########                                                                                                                           #############################
###################################    #########                                                                                                                           #############################
###################################    #########                                                                                                                           #############################
###################################    #########     ################################    #####    ######################################    #############################################################
########################    #######    #########     ################################    #####    ######################################    ############################################################
########################    #######    ##########    ################################    #####    ######################################    ############################################################
########################    #######    ##########    ################################    #####    ######################################    ############################################################
########################    #######    ##########    ################################    #####    ######################################    ############################################################
########################    #######    ##########    ################################    #####    ######################################    ############################################################
########################    #######    ##########    ################################    #####    ######################################    ############################################################
########################    #######    ##########    ################################    #####                     #####################    ############################################################
########################    #######    ##########    ################################    #####                                    ######    ############################################################
########################    #######    ##########    ################################    #####                                    ######    ############################################################
########################                             ################################    #####    ######################################    ############################################################
########################                            ################################    #####    ######################################     ############################################################
#########################                            ################################    #####    ######################################    ############################################################
#####################################################################################    #####    ######################################    ############################################################
#####################################################################################    #####    ######################################################################################################
#####################################################################################    #####    ######################################################################################################
#####################################################################################    #####    ######################################################################################################
#####################################################################################    #####    ######################################################################################################
#####################################################################################    #####    ######################################################################################################
#####################################################################                    #####    ######################################################################################################
#####################################################################                    #####                                ###########################################################################
##############################################################################################                                ##########################################################################
###############################################################################################                               ###########################################################################
########################################################################################################################################################################################################
########################################################################################################################################################################################################
########################################################################################################################################################################################################
########################################################################################################################################################################################################
########################################################################################################################################################################################################
########################################################################################################################################################################################################
########################################################################################################################################################################################################
########################################################################################################################################################################################################
########################################################################################################################################################################################################
########################################################################################################################################################################################################
########################################################################################################################################################################################################
########################################################################################################################################################################################################
########################################################################################################################################################################################################
########################################################################################################################################################################################################
########################################################################################################################################################################################################
########################################################################################################################################################################################################
########################################################################################################################################################################################################
########################################################################################################################################################################################################
########################################################################################################################################################################################################
