########################################################################################################################################################################################################
########################################################################################################################################################################################################
########################################################################################################################################################################################################
########################################################################################################################################################################################################
########################################################################################################################################################################################################
########################################################################################################################################################################################################
########################################################################################################################################################################################################
########################################################################################################################################################################################################
########################################################################################################################################################################################################
########################################################################################################################################################################################################
########################################################################################################################################################################################################
########################################################################################################################################################################################################
########################################################################################################################################################################################################
########################################################################################################################################################################################################
########################################################################################################################################################################################################
########################################################################################################################################################################################################
########################################################################################################################################################################################################
###################################################################################################################################################################   ##################################
###################################################################################################################################################################   ##################################
###################################################################################################################################################################   ##################################
########################################################################################################################################################################################################
########################################################################################################################################################################################################
#######################################################################################################################################################   ##############################################
###############################################################################################################################################            #############################################
########################################################################################################################################                   #############################################
###################################################################################################################################              #######    ############################################
###################################################################################################################### #######           ################   ############################################
#################################################################################################################       #            #####################   ###########################################
############################################################################################################                   ###########################    ##########################################
######################################################################################################            ####     ################################   ##########################################
################################################################################################             ###############################################   #########################################
##################################################################################                      ####################################################    ########################################
############################################################################                       ##########################################################   ########################################
########################################################################              #######################################################################    #######################################
#######################################################################      #################################################################################    ######################################
#######################################################################   #####################################################################################   ######################################
#######################################################################   #####################################################################################    #####################################
#######################################################################    #####################################################################################   #####################################
########################################################################   ######################################################################################   ####################################
########################################################################   ######################################################################################    ###################################
########################################################################    ######################################################################################   ###################################
#########################################################################   ######################################################################################    ##################################
#########################################################################   #######################################################################################   ##################################
#########################################################################   ########################################################################################   #################################
##########################################################################   #######################################################################################    ################################
##########################################################################   #################### ###################################################################   ################################
##########################################################################   ###################  @###################################################################   ###############################
##########################################################################    ##################   ###################################################################    ##############################
###########################################################################   ################ #   ####################################################################   ##############################
###########################################################################   ###        @         #####################################################################   #############################
###########################################################################   ###        @          ####################################################################   #############################
####################################################################@  ####   ##   ##############   #####################################################################   ############################
####################################################################   ####   @    ##############   ####################    #############################################    ###########################
####################################################################                #############   ##################      ##############################################   ###########################
#################################################################           ###            @#####                                                ##########################   ##########################
############################################################            ######               ####@             @                                  #########################    #########################
######################################################            #########        ######    ############################   ###################   ##########################   #########################
#################################################           ############@       #########    ############################   ###################   ##########################    ########################
############################################           #####                ####             ############################   ##################    ###########################    #######################
#######################################           ######                         #######            #####################   ##################   #############################   #######################
##################################            #####      ############            ########                               #   ##################   #############################    ######################
#############################           #########     ###############@  ###@  #############                             #   ##################   ##############################   ######################
#######################            ##############@  ################## ####  ##############  #######################   @#   ###################  ###############################   #####################
##################            ###################   #######################################  #######################    #    ##################   ##############################    ####################
#################       #########################    ####### ##############################  #############   #######    #    ##################   ###############################   ####################
##################   #########  ##################   ####### ##############################@ #######################    #  @###################   ###############################    ###################
##################    #######    #################   ####### #######################################################        ###################   ################################   ###################
###################   ########   ################    ###############################################################        ###################   #################################   ##################
###################   ########  @################     ##############################################################   ##   ###################   #################################    #################
####################   ########   ###########@        ##############################################################  ####  ###################   ##################################   #################
####################   ########   ###########   ###  @##############################################################   ##   ###################   ###   ############################    ################
####################    ########@  ###########  ###    #############################################################   ##    ####  @###########   #####@  ###########################   ################
#####################   ########   ###########  ####    #############  #############  #############  ##############    ###                                   @########################   ###############
#####################   #########   ##########   ##      ############  #############  #############  ##############   #####     @                             ########################    ##############
######################   ########@  ###########             #                                                ##                 ###################    ################################   ##############
######################   ########    ####           ##                                                                         #####################   ################################    #############
######################   #########               @###@   #################                                          ################################  @########################            #############
#######################   #######          #########   ###############################################################################                                                     #############
#######################   ########   #############    ###################################################### ############                                                                  #############
#######################                                                                                                                  ###########   #################################################
########################                                                                                                    ############################################################################
#########################   ################################################################################  ##########################################################################################
########################################################################################################################################################################################################
########################################################################################################################################################################################################
########################################################################################################################################################################################################
########################################################################################################################################################################################################
########################################################################################################################################################################################################
########################################################################################################################################################################################################
########################################################################################################################################################################################################
########################################################################################################################################################################################################
########################################################################################################################################################################################################
########################################################################################################################################################################################################
########################################################################################################################################################################################################
########################################################################################################################################################################################################
########################################################################################################################################################################################################
########################################################################################################################################################################################################
########################################################################################################################################################################################################
########################################################################################################################################################################################################
########################################################################################################################################################################################################
########################################################################################################################################################################################################
